##############
B   #####    #
###       ## #
##### ########
##    ## ### E
## ####    # #
## #    ## # #
##   ## ## # #
### ### ## # #
# # ### #  # #
# #   # # ## #
# ### # #    #
#     # ######
##############
